30 30

911166504332291116650433229111
117171110000011717111000001171
196111330111111111111111111961
110000003109111000000310911100
711113333101171111333310117111
554511133101955251113310195545
234433111101123343311110112344
333333223303133433322330313333
911166504332291516650433229111
117171110000011617111000001171
196111330111119711133011111961
110000003109111800000310911100
711113333101171214333310117111
554511133101955451113310195545
234433111101123443311110112344
333333223303133333322330313333
911166504332291116650433229111
117171110000011717111000001171
196111330111119611133011111961
110000003109111000000310911100
711113333101171111333310117111
554511133101955451113310195545
234433111101123443311110112344
333333223303133333322330313333
110000003109111000000310911100
911166504332291116650433229111
117171110000011717111000001171
196111330111119611133011111961
911166504332291116650433229111
711113333101171111333310117111
