8 13

0001000000000
0001111100000
0000000100000
0000000111100
0000000000100
0000111111100
0000100000000
0000100000000
