8 13
             
9111665043322
1171711110000
1961117001111
1100007031091
7111137331811
5545111331019
2344331111011
3333332233031
