8 13
             
9111665043322
1171711100000
1961113301111
1100000031091
7111133331011
5545111331019
2344331111011
3333332233031
