8 13

1101010101001
0101111101111
0100100111010
0111911000010
0100001111000
0111000001111
0100000000001
0111000000001
