8 13

0001000111110
0111111100015
0900000100001
0110000191101
0090000000901
0110111111101
0900100010001
0111100011111
